#####
#G  #
#   #
#  G#
#S# #
#   #
#SSS#
#####
