#####
#G# #
# S #
#  G#
#S# #
#   #
#SSS#
#####
