############
#   SSS#   #
#  #####   #
#    #   G #
#   SSS    #
############
