############
#   SSS    #
########## #
#    G     #
# ##########
#   SSS    #
############
