######################
#        #         G #
#            ##      #
#       S#############
#      ###           #
#      ###           #
#        #           #
## #######           #
#   S                #
#                    #
#                    #
#                    #
#                    #
#                    #
#                  S #
######################
